^^^^^^^^```````````````````````````````````````^^^^^^^^^
^^^^^^^``````````````````````**`````````````````^^^^~~^^
^^^^^^`````````````````````****``````````````````^^~~~^^
^^^^``````````````````````******``````````````````~~~~``
^^^`````````````````````````***``````````````````~~~~~``
^^`````````````````````````````````````````````~~~~~````
``````~~`````````````````````````````````````~~~~~~~````
`````~~~~`````````````````````````````````~~~~~~~~``````
`````~~~~~`````````````````````````````````~~~~~~```````
`````~~~~~```````````````````````````````````~~~````````
`````~~~~~~`````````````````````````````````````````````
``````~~~~~~````````````````````````````````````````````
``````~~~~~~~```````````````````````````````````````````
```````~~~~~~~``````````````````````````````````````````
``````````~~~~``````````````````````````````````````````
````````````````````````````````````````````````````````
````````````````````````````````````````````````````````
````````````````````````````````````````````````````````
````````````````````````````````````````***`````````````
``````````**``````````````````````````******````````````
````````****```````````````````````````****````````^^```
```````******````````````````````````````**````````^^^``
`````````***```````````````````````````````````````^^^^`
``````````````````````````````````````````````````^^^^^^
`````````````````````````````````````````````````^^^^^^^
`````````````````````````````````````````````````^^^^^^^
````````````````````````````````````````````````^^^^^^^^
            