^^^^^^^^```````````````````````````````````````^^^^^^^^^
^^^^^^^``````````````````````**`````````````````^^^^~~^^
^^^^^^`````````````````````****``````````````````^^~~~^^
^^^^``````````````````````******``````````````````~~~~``
^^^`````````````````````````***``````````````````~~~~~``
^^`````````````````````````````````````````````~~~~~````
`````````````````````````````````````````````~~~~~~~````
``````````````````````````````````````````~~~~~~~~``````
```````````````````````````````````````````~~~~~~```````
`````````````````````````````````````````````~~~````````
````````````````````````````````````````````````````````
`````````````````````"""""""""``````````````````````````
```````````````````""~~~~~~~~~""````````````````````````
```````````````````"~~~~~~~~~~~"````````````````````````
```````````````````"~~~~~~~~~~~"````````````````````````
```````````````````"~~~~~~~~~~~"````````````````````````
```````````````````"~~~~~~~~~~~"````````````````````````
```````````````````""~~~~~~~~~""````````````````````````
`````````````````````"""""""""``````````***`````````````
``````````**``````````````````````````******````````````
````````****```````````````````````````****````````^^```
```````******````````````````````````````**````````^^^``
`````````***```````````````````````````````````````^^^^`
``````````````````````````````````````````````````^^^^^^
`````````````````````````````````````````````````^^^^^^^
`````````````````````````````````````````````````^^^^^^^
````````````````````````````````````````````````^^^^^^^^
            